11111111111111111
1E00010111101110S
11110100000010001
11000001111000111
11111111111111111
